PPPPPPPPPPWWWWWWWWWW
PWWWWWWWWPWWPPPPWWWW
PWWWWWWWWPWWPWWPWWWW
PWWWWWWWWPWWPWWPWWWW
PWWWWWWWWPWWPWWPPPPD
PWWWWWWWWPPPPWWWWWWW
PWWWWWWWWPWWPWWWWWWW
PPPWWWWWWPWWPWWWWWWW
WWPWWWWWWPWWPWWWWWWW
WWPPPPPPPPWWPWWWWWWW
WWPWWWWWWPWWPPPPWWWW
WWPWWWWWWPWWPWWPWWWW
WWPWWWWWWPWWPWWPWWWW
WWPWWWWWWPWWPWWPWWWW
WWDWWWWWWSWWSWWSWWWW
0320
2005