WWWWWWWWWWWWWWWWWWWW
DPPPPPPPPPWPWWWPPPPW
WWWWWWWWWPWPWWWPWWPW
WWWWWWWWWPWPWWWPWWPW
WWPPPPPPPPPPWWWPWWPD
WWPPPPPWWWWWWWPPPWPW
WWPPPPPWWPPPPPPWPWPW
WWPPWPPWWPWWWWWWPWPW
WWPPPPPPPPWWWWWWPPPW
WWWWWWWWWWWWWWWWWWWW
12

w = wall
D = door
P = path
